NO ./texture
SO ./texture
WE ./texture
EA ./texture

F 255 , 100 , 0
C 225 , 255, 255

        111111111111111111111111111111111111111111111111111111111111111111111111111
  00      10000000001100000000000000000000000001110000000000000000000000000111111101111
        1111000001110000000000001110000000000000000000000000111000000000000000000000001
        1001000000000000000000001110000000000N000000000000001110000000000000000000000001
11111111101100000111000000000000111000000000000000000000000011100000000000000000000000001
1000000000110000000000000000000000000000000000000000000000011101111111111111111111111111
111101111111110111000000000000000011111110000000000000000000000000000000000000000001001
1111011111111101100000000000000001      1000000000000000000000000000000000101010010001
11000000110101011100000000000000001     100000000000000000000000000000000000000010001
100000000000000011000000100010000001111110000000000011111111111111111111111111111111
10000000000000001101000000000000000000000000000000000000000000010010001
1100000111010101111000000000000000000000000000000000000000000101111111
11110111 1110101 10111100000000000000000000001000111111111111
11111111 1111111 1111111111111111111111111111 111
