NO ./tex/north_wall.xpm
SO ./tex/south_wall.xpm
WE ./tex/west_wall.xpm
EA ./tex/east_wall.xpm

F 255 , 100 , 0
C 225 , 255, 255

1111111111111111111111111111111111111111111111111
1000000000000000000000000000000000000000000000001
1000000000000000000000000000000000000000000000001
1000000000000000000000000000000000000000000000001
1000000000000000000000000000000000000000000000001
1000000000000000000000000000000000000000000000001
1000000000000000000000000000000000000000000000001
1111111111110000000000000000000000000000000000001
1000000000010000000000000000000000000000000000001
1112111000010000000000000000000000000000000000001
1000001000011121000000000000000000000000000000001
1000001000000001000000000000000000000000000000001
1000001000000001000000000000000000000000000000001
100N001000000001000000000000000000000000000000001
1111111111111111111111111111111111111111111111111
