NO ./textures/wall4.xpm
SO ./textures/wall4.xpm
WE ./textures/wall4.xpm                                  
EA ./textures/wall4.xpm

F 222, 184, 135
C 0, 191, 255

1111111111111111111111111111111111111111111111111
1000000000000000000000000000000000000000000000001
1000000000000000000000000000000000000000000000001
1000000000000000000000000000000000000000000000001
1000000000000000000000000000000000000000000000001
1000000000000000000000000000000000000000000000001
1000000000000000000000000000000000000000000000001
1000000000000000000000000000000000000000000000001
1000000000000000000000000000000000000000000000001
1112111000000000000000000000000000000000000000001
1000001000000000000000000000000000000000000000001
1000001000000000000000000000000000000000000000001
1000001000000000000000000000000000000000000000001
100N001000000000000000000000000000000000000000001
1111111111111111111111111111111111111111111111111
