NO ./textures/mur1.xpm
SO ./textures/mur2.xpm
WE ./textures/pillar1.xpm
EA ./textures/pillar2.xpm

F 255, 100, 0
C 64, 224, 208

111111111111111
100000000000001
100000000000001
100000000000001
100000000000001
100000000010001
100000010000001
1000000N0000001
100000000000001
100000000000001
100000000000001
100000000000001
100000000000001
100000000000001
111111111111111
