NO ./textures/mur1.xpm
SO ./textures/mur2.xpm
WE ./textures/pillar1.xpm
EA ./textures/pillar2.xpm

F 255, 100, 0
C 225, 255, 255

11111111111111
10000000000001
100000000S0001
10000000000001
10001111111111
10001
11111
