NO ./textures/pillar1.xpm
SO ./textures/zaunwall.xpm
WE ./textures/pillar3.xpm                                  
EA ./textures/pilpil.xpm

F 222, 184, 135
C 0, 191, 255

        1111111111111111111111111
        100000000011000000N000001
        1011000001110000000000001
        1001000000000000000000001
111111111011000001110000000000001
100000000011000001110111111111111
11110111111111011100000010001
11110111111011011101010010001
11000000110001011100000010001
10000000000000001100000010001
10000000000000001101010010001
1100000111010101111101111000111
11110111 1110101 101111010001
11111111 1111111 111111111111
