NO ./tex/caitlyn_wall.xpm
SO ./tex/caitlyn_wall.xpm
WE ./tex/victor_wall.xpm
EA ./tex/victor_wall.xpm

F 255 , 100 , 0
C 225 , 255, 255

111111111111
100000000001
100000000001
100000000001
10000W000001
111111111111
100000000001
111111111111
