NO ./tex/north_wall.xpm
SO ./tex/south_wall.xpm
WE ./tex/west_wall.xpm
EA ./tex/east_wall.xpm

F 255 , 100 , 0
C 225 , 255, 255

111111111111
100000000001
100000000001
100000000001
10100N000101
100000000001
100000000001
111111111111
