NO ./tex/wall1.xpm
SO ./tex/wall2.xpm
WE ./tex/wall3.xpm
EA ./tex/wall4.xpm

F 255 , 100 , f
C 225 , 255, 255

    1111111111111111111111111111
        1000000000110000000000001
        1011000001110000000000001
        1001000000000000000000001
11111111111000001110000000000001
100000001011000001110111111111111
11110111111111011100000010001
11110111111111011101010010001
11000000111101011100000010001
1000000001  10001100000010001
10000000001100001101010010001
1100000111010101111101111000111
11110111 1110101 10111101S001 
11111111 1111111 111111111111