NO ./tex/piltover1.xpm
SO ./tex/piltover2.xpm
WE ./tex/piltover3.xpm
EA ./tex/piltover1.xpm

F 245, 222, 179
C 225, 255, 255

1111111
100N001
1011111
111 0
