F 255 , 100 , 0
C 225 , 255, 255

    1111111111111111111111111
        1000000000110000000001111
        1011000001110000000000001
        1001000000000000000000001
111111111011000001110000000000001
100000000011000001110111111111111
11110111111111011100000010001
11110111111111011101010010001
11000000110101011100000010001
1000000001  10001100000010001
10000000001100001101010010001
1100000111010101111101111000111
11110111 1110101 101111010001 N
11111111 1111111 111111111111
NO ./texture
SO ./texture
WE ./texture
EA ./texture